111111111111111
10P0CE000000001
111111111111111
