111111111111111
1000CEP00000001
100000000000001
111111111111111
