11111111111111111111
1P011111111111111111
11C01111111111111111
11100111111111111111
11110C11111111111111
11111001111111111111
11111100000000000011
111111111111C11C1011
11E00000000111111011
11111111110000000011
11111111111111111111
