11111111111111111111
1P00000000000C100001
10000000100000000001
10000001E100000000C1
10000000000000000001
10000001C10000000001
10000000100000000001
10000000000000000011
100000C0000000000011
11000000000000000001
11111111111111111111
