111111111111111
100000000C00101
10P000000000101
1000C0000001101
1000000000010E1
100000000001001
111111111111111
