11111111111111111111
1P00000000000C1001C1
100000001000000001E1
100000010100000001C1
10000000000000000001
10000001C10000000001
10000000100000000001
10000000000000000011
100000C0000000000011
11000000000000000001
11111111111111111111
