11111111111111111111
1P00000000000C100MC1
100000001000000000M1
10000001E10000M000C1
10000000000000000001
10000001C10000000001
10000000100000000001
100M0000000000M00011
100000C0000000000011
110000000000M0000001
11111111111111111111
